20 11
7 7 7 7 7 7 7 7 7 7 7 7 7 7 7 7 7 7 7 7 
7 1 1 1 1 1 1 1 1 1 1 1 1 1 1 1 1 1 1 7 
7 1 1 1 1 1 1 1 1 1 1 1 1 1 1 1 1 1 1 7 
7 1 1 1 1 1 1 1 1 1 1 1 1 1 1 1 1 1 1 7 
7 1 1 1 1 1 1 1 1 1 1 1 1 1 1 1 1 1 1 7 
7 1 1 1 1 1 1 1 1 1 1 1 1 1 1 1 1 1 1 7 
7 1 1 1 1 1 1 1 1 1 1 1 1 1 1 1 1 1 1 7 
7 1 1 1 1 1 1 1 1 1 1 1 1 1 1 1 1 1 1 7 
7 1 1 1 1 1 1 1 1 1 1 1 1 1 1 1 1 1 1 7 
7 1 1 1 1 1 1 1 1 1 1 1 1 1 1 1 1 1 1 7 
8 8 8 8 8 8 8 8 8 8 8 8 8 8 8 8 8 8 8 8 
